111111
100001
101KL1
100001
111111